%%%%%%%%%
%..   ..%
%   .   %
%   P   %
%.     .%
%. .   .%
%%%%%%%%%
