%%%%%%%%
%    .P%
%      %
%.     %
%%%%%%%%
