%%%%%%%%%%%%%%%%%%%%
%.    .      .    .%
%.%%.%.%%%%%%.%.%%.%
%......      ......%
% %%%%%%%%%%%%%%%% %
%      31%%24      %
%%%%%%%%%%%%%%%%%%%%
