%%%%%%%%%%%%%%%%%%%%
%.           ..    %
%.  .  .  .  .     %
%        P         %
%                  %
%.....             %
%%%%%%%%%%%%%%%%%%%%
