%%%%%%%%%%%%
%P ... ... %
%  %%% %%% %
%G ... ... %
%%%%%%%%%%%%
